  ####
###P.# 
#..GB##
#...B.#
#.#G..#
#.....#
#######