--###--
###P.##
#..GB##
#...B.#
#.#G..#
#.....#
#######